.........................
.........................
.........................
.........................
.........................
.........................
.........................
.........ccc.............
.........###.............
.........................
...pccc.......ccc...##...
....###.......###........
.........................
......c..................
##########..#############